2-3
Angola
Turkmenistan

1-3
Tuvalu

3-4
St. Kitts and Nevis



http://data.worldbank.org/about/country-classifications/country-and-lending-groups#Low_income

36
Low-income economies ($1,025 or less)

Afghanistan	Gambia, The	Mozambique
Bangladesh	Guinea	Myanmar
Benin	Guinea-Bisau	Nepal
Burkina Faso	Haiti	Niger
Burundi	Kenya	Rwanda
Cambodia	Korea, Dem Rep.	Sierra Leone
Central African Republic	Kyrgyz Republic	
Somalia 
Chad	Liberia	Tajikistan
Comoros	Madagascar	Tanzania
Congo, Dem. Rep	Malawi	Togo
Eritrea	Mali	Uganda
Ethiopia	Mauritania	Zimbabwe

54
Lower-middle-income economies ($1,026 to $4,035)

Albania	Indonesia	Samoa
Armenia	India	São Tomé and Principe
Belize  	Iraq	
Senegal
Bhutan	Kiribati	Solomon Islands
Bolivia	Kosovo  	South Sudan
Cameroon	Lao PDR	Sri Lanka
Cape Verde	Lesotho	Sudan
Congo, Rep.	Marshall Islands	Swaziland
Côte d'Ivoire	Micronesia, Fed. Sts.	Syrian Arab Republic
Djibouti	Moldova	Timor-Leste
Egypt, Arab Rep.	Mongolia	Tonga
El Salvador	Morocco	Ukraine
Fiji	Nicaragua	
Uzbekistan
Georgia	Nigeria  	Vanuatu
Ghana	Pakistan  	Vietnam
Guatemala	Papua New Guinea  	West Bank and Gaza
Guyana	Paraguay	Yemen, Rep. 
Honduras	Philippines	Zambia

54
Upper-middle-income economies ($4,036 to $12,475)

Angola
Ecuador	Palau
Algeria	Gabon	Panama
American Samoa	Grenada	Peru  
Antigua and Barbuda 
Iran, Islamic Rep. 	Romania
Argentina	
Jamaica 
Russian Federation
Azerbaijan
Jordan	Serbia
Belarus	Kazakhstan	Seychelles
Bosnia and Herzegovina	Latvia	South Africa
Botswana	Lebanon	St. Lucia
Brazil	Libya	St. Vincent and the Grenadines
Bulgaria	Lithuania	Suriname
Chile	Macedonia, FYR  	Thailand
China	Malaysia	Tunisia
Colombia	Maldives	Turkey
Costa Rica	Mauritius	Turkmenistan
Cuba	Mexico	Tuvalu
Dominica	Montenegro	Uruguay
Dominican Republic  	Namibia	Venezuela, RB

70
High-income economies ($12,476 or more)

Andorra	Germany	Oman
Aruba	Greece	Poland
Australia	Greenland	
Portugal 
Austria	Guam	Puerto Rico
Bahamas, The	Hong Kong SAR, China	Qatar
Bahrain	Hungary	San Marino
Barbados	Iceland	Saudi Arabia
Belgium	Ireland	Singapore
Bermuda	Isle of Man	Sint Maarten
Brunei Darussalam	Israel	Slovak Republic
Canada	Italy	Slovenia
Cayman Islands	Japan	Spain
Channel Islands	Korea, Rep.	St. Kitts and Nevis
Croatia 	Kuwait	St. Martin
Curaçao	
Liechtenstein 
Sweden
Cyprus	Luxembourg	Switzerland
Czech Republic	Macao SAR, China	
Trinidad and Tobago 
Denmark	Malta	Turks and Caicos Islands
Estonia	Monaco	United Arab Emirates
Equatorial Guinea	Netherlands	United Kingdom
Faeroe Islands	New Caledonia	United States
Finland	New Zealand	Virgin Islands (U.S.)
France	Northern Mariana Islands	 
French Polynesia	Norway